############
#     #    #
# $  ## $  #
#   #  .   #
# $  @ ##  #
#   ##  .  #
#  .   #   #
#    $     #
#  #   # . #
#      #   #
# .    $   #
############
