#########
#       #
#   $   #
#  #@   #
#       #
#   .   #
#########
