#######################
#       #       #
#   $   #   $   #
#  #@   #  #&   #
#       #       #
#   .   #   .   #
#######################
