#######
#     #
# .$@ #
#  *  #
#######
