#################
#       #       #
#   $   #   $   #
#  #@   #  #&   #
#       #       #
#   .   #   .   #
#################
